nail		钉子
coffin		棺材
miraculously	奇迹般的
around		存在着的
steady		持续的
downward	向下的，朝下的
trajectory	轨道
threshold	门槛，关口
debuted		首次亮相，出道
instant		即刻的
hit		轰动一时的人物
virtual		几乎
monopoly	垄断
innovate	改革
essentially	本质上
cobweb		蜘蛛网
frustrated	使...沮丧
flee		逃跑
greenerpastures	更好的事物或地方
synonymous	同义的
pave		铺地面
surpass		超过
sync		同步
mainstays	支柱，主要部分
sophisticated	复杂的
landscape	形势
investment	投资
\\\\\\\\\\\\\\\\\\\\\\\\\\\\\\\\\\\\\\\\
nail | BrE neɪl, AmE neɪl |
A.noun	钉子
Microsoft drivers another nail in the coffin of its most hated product.



\\\\\\\\\\\\\\\\\\\\\\\\\\\\\\\\\\\\\\\\
around | BrE əˈraʊnd, AmE əˈraʊnd |
A.adverb	存在着的
IE is miraculously still around after 25 years.



\\\\\\\\\\\\\\\\\\\\\\\\\\\\\\\\\\\\\\\\
